*---*---*;
-3hhhhh4-;
--3qqq4--;
-q-3q4-q-;
-qq---qq-;
-qqq-qqq-;
-qqqqqqq-;
---------;
---------;
---------;
---------;
