*---*---*;
-2qqqqq1-;
-qqqqqqq-;
-q*qqq*q-;
-3qhhhq4-;
--qqhqq--;
-q-q-q-q-;
---------;
---------;
---------;
---------;
