-*----*--;
2qqqqqq2-;
--*---*--;
-1hhhhhh4;
-*---*---;
qqqqqqq3-;
-qqhhhqq-;
---------;
---------;
---------;
---------;
